"filename", "language", "XML", "Markdown", "Java Properties", "Java", "Batch", "comment", "blank", "total"
"c:\Users\lisni\git\Projet_POO\.mvn\wrapper\MavenWrapperDownloader.java", "Java", 0, 0, 0, 76, 0, 31, 11, 118
"c:\Users\lisni\git\Projet_POO\.mvn\wrapper\maven-wrapper.properties", "Java Properties", 0, 0, 2, 0, 0, 0, 1, 3
"c:\Users\lisni\git\Projet_POO\README.md", "Markdown", 0, 20, 0, 0, 0, 0, 16, 36
"c:\Users\lisni\git\Projet_POO\mvnw.cmd", "Batch", 0, 0, 0, 0, 96, 51, 36, 183
"c:\Users\lisni\git\Projet_POO\pom.xml", "XML", 145, 0, 0, 0, 0, 0, 20, 165
"c:\Users\lisni\git\Projet_POO\src\main\java\fr\pantheonsorbonne\miage\game\classes\cards\Card.java", "Java", 0, 0, 0, 50, 0, 11, 14, 75
"c:\Users\lisni\git\Projet_POO\src\main\java\fr\pantheonsorbonne\miage\game\classes\cards\CardColor.java", "Java", 0, 0, 0, 25, 0, 3, 6, 34
"c:\Users\lisni\git\Projet_POO\src\main\java\fr\pantheonsorbonne\miage\game\classes\cards\CardValue.java", "Java", 0, 0, 0, 62, 0, 18, 9, 89
"c:\Users\lisni\git\Projet_POO\src\main\java\fr\pantheonsorbonne\miage\game\classes\cards\ConsoleColors.java", "Java", 0, 0, 0, 60, 0, 8, 9, 77
"c:\Users\lisni\git\Projet_POO\src\main\java\fr\pantheonsorbonne\miage\game\classes\cards\InvertedCard.java", "Java", 0, 0, 0, 6, 0, 2, 5, 13
"c:\Users\lisni\git\Projet_POO\src\main\java\fr\pantheonsorbonne\miage\game\classes\cards\WinCondition.java", "Java", 0, 0, 0, 15, 0, 12, 6, 33
"c:\Users\lisni\git\Projet_POO\src\main\java\fr\pantheonsorbonne\miage\game\classes\cards\WinningCombination.java", "Java", 0, 0, 0, 36, 0, 0, 6, 42
"c:\Users\lisni\git\Projet_POO\src\main\java\fr\pantheonsorbonne\miage\game\classes\playerStuff\NetworkPlayerBot.java", "Java", 0, 0, 0, 141, 0, 1, 9, 151
"c:\Users\lisni\git\Projet_POO\src\main\java\fr\pantheonsorbonne\miage\game\classes\playerStuff\Player.java", "Java", 0, 0, 0, 153, 0, 8, 36, 197
"c:\Users\lisni\git\Projet_POO\src\main\java\fr\pantheonsorbonne\miage\game\classes\playerStuff\PlayerBot.java", "Java", 0, 0, 0, 33, 0, 13, 5, 51
"c:\Users\lisni\git\Projet_POO\src\main\java\fr\pantheonsorbonne\miage\game\classes\playerStuff\PlayerBotSmarter.java", "Java", 0, 0, 0, 29, 0, 4, 3, 36
"c:\Users\lisni\git\Projet_POO\src\main\java\fr\pantheonsorbonne\miage\game\classes\playerStuff\PlayerHand.java", "Java", 0, 0, 0, 46, 0, 0, 12, 58
"c:\Users\lisni\git\Projet_POO\src\main\java\fr\pantheonsorbonne\miage\game\classes\pokerTableStuff\AllInPot.java", "Java", 0, 0, 0, 6, 0, 7, 6, 19
"c:\Users\lisni\git\Projet_POO\src\main\java\fr\pantheonsorbonne\miage\game\classes\pokerTableStuff\Blind.java", "Java", 0, 0, 0, 25, 0, 1, 9, 35
"c:\Users\lisni\git\Projet_POO\src\main\java\fr\pantheonsorbonne\miage\game\classes\pokerTableStuff\DealerHand.java", "Java", 0, 0, 0, 52, 0, 3, 9, 64
"c:\Users\lisni\git\Projet_POO\src\main\java\fr\pantheonsorbonne\miage\game\classes\pokerTableStuff\Deck.java", "Java", 0, 0, 0, 53, 0, 15, 13, 81
"c:\Users\lisni\git\Projet_POO\src\main\java\fr\pantheonsorbonne\miage\game\classes\pokerTableStuff\NetworkPokerTableAutomatisee.java", "Java", 0, 0, 0, 189, 0, 23, 17, 229
"c:\Users\lisni\git\Projet_POO\src\main\java\fr\pantheonsorbonne\miage\game\classes\pokerTableStuff\PokerTable.java", "Java", 0, 0, 0, 438, 0, 119, 55, 612
"c:\Users\lisni\git\Projet_POO\src\main\java\fr\pantheonsorbonne\miage\game\classes\pokerTableStuff\PokerTableAutomatisee.java", "Java", 0, 0, 0, 136, 0, 19, 17, 172
"c:\Users\lisni\git\Projet_POO\src\main\java\fr\pantheonsorbonne\miage\game\classes\pokerTableStuff\Pot.java", "Java", 0, 0, 0, 55, 0, 14, 4, 73
"c:\Users\lisni\git\Projet_POO\src\main\java\fr\pantheonsorbonne\miage\game\classes\superpowers\Superpower.java", "Java", 0, 0, 0, 35, 0, 0, 7, 42
"c:\Users\lisni\git\Projet_POO\src\main\java\fr\pantheonsorbonne\miage\game\classes\superpowers\SuperpowerAdd.java", "Java", 0, 0, 0, 21, 0, 0, 4, 25
"c:\Users\lisni\git\Projet_POO\src\main\java\fr\pantheonsorbonne\miage\game\classes\superpowers\SuperpowerAddHidden.java", "Java", 0, 0, 0, 19, 0, 0, 4, 23
"c:\Users\lisni\git\Projet_POO\src\main\java\fr\pantheonsorbonne\miage\game\classes\superpowers\SuperpowerDestroy.java", "Java", 0, 0, 0, 18, 0, 0, 3, 21
"c:\Users\lisni\git\Projet_POO\src\main\java\fr\pantheonsorbonne\miage\game\classes\superpowers\SuperpowerOther.java", "Java", 0, 0, 0, 18, 0, 0, 4, 22
"c:\Users\lisni\git\Projet_POO\src\main\java\fr\pantheonsorbonne\miage\game\classes\superpowers\SuperpowerSelf.java", "Java", 0, 0, 0, 19, 0, 0, 2, 21
"c:\Users\lisni\git\Projet_POO\src\main\java\fr\pantheonsorbonne\miage\game\classes\superpowers\SuperpowerShow.java", "Java", 0, 0, 0, 30, 0, 3, 4, 37
"c:\Users\lisni\git\Projet_POO\src\main\java\fr\pantheonsorbonne\miage\game\logic\WinConditionLogic.java", "Java", 0, 0, 0, 232, 0, 103, 26, 361
"c:\Users\lisni\git\Projet_POO\src\main\java\fr\pantheonsorbonne\miage\game\main\LocalTexasHoldEm.java", "Java", 0, 0, 0, 21, 0, 0, 7, 28
"c:\Users\lisni\git\Projet_POO\src\main\resources\application.properties", "Java Properties", 0, 0, 9, 0, 0, 35, 8, 52
"c:\Users\lisni\git\Projet_POO\src\main\resources\log4j2.properties", "Java Properties", 0, 0, 10, 0, 0, 16, 4, 30
"c:\Users\lisni\git\Projet_POO\src\test\java\fr\pantheonsorbonne\miage\game\classes\cards\CardsTest.java", "Java", 0, 0, 0, 75, 0, 6, 8, 89
"c:\Users\lisni\git\Projet_POO\src\test\java\fr\pantheonsorbonne\miage\game\classes\playerStuff\PlayerTests.java", "Java", 0, 0, 0, 21, 0, 1, 5, 27
"c:\Users\lisni\git\Projet_POO\src\test\java\fr\pantheonsorbonne\miage\game\classes\pokerTableStuff\BlindsTest.java", "Java", 0, 0, 0, 37, 0, 3, 8, 48
"c:\Users\lisni\git\Projet_POO\src\test\java\fr\pantheonsorbonne\miage\game\classes\pokerTableStuff\PokerTableTest.java", "Java", 0, 0, 0, 770, 0, 90, 60, 920
"c:\Users\lisni\git\Projet_POO\src\test\java\fr\pantheonsorbonne\miage\game\logic\WinConditionLogicTest.java", "Java", 0, 0, 0, 267, 0, 29, 27, 323
"Total", "-", 145, 20, 21, 3269, 96, 649, 515, 4715